32 32 32 32 32 32 32 32 32 32 32 32 32 32 32 32 32 32 32 32 32 32 32 32 32 32 32 32 32 32 32 32 32 32 32 32 32 32 32 32 32 32 32 32 32 32 32 32 32 32 32 32 32 32 32 32 32 32 32 07 07 07 07 07
32 32 35 35 32 32 32 32 32 32 32 35 35 32 32 32 32 32 32 32 35 35 32 32 32 35 35 32 32 32 32 32 32 32 32 32 32 35 32 32 32 32 32 32 01 01 35 35 32 32 32 32 32 32 32 35 32 32 32 07 33 33 33 07
32 35 35 35 35 35 32 32 32 35 35 35 35 35 32 32 32 32 35 35 35 35 35 35 35 35 35 35 35 32 32 32 32 32 32 32 35 35 35 32 32 32 01 01 01 01 35 01 01 35 32 32 32 35 35 35 26 32 32 07 4F 33 33 07
32 32 35 35 35 35 35 35 35 35 35 35 35 35 35 32 32 35 35 35 35 35 35 35 35 35 35 35 35 35 32 32 32 32 32 32 32 35 32 32 32 01 01 01 01 01 01 01 35 32 32 32 32 35 35 26 26 26 32 07 33 33 33 07
32 32 35 35 35 35 35 35 35 35 35 35 35 35 35 35 35 35 35 35 35 35 35 35 35 35 35 35 35 35 35 32 32 32 35 35 32 32 32 35 35 35 35 01 01 01 35 35 35 35 32 32 35 35 35 26 26 35 32 07 07 09 07 07
32 35 35 35 35 35 35 35 35 01 01 01 35 35 35 35 35 35 35 35 35 35 35 35 35 35 35 35 35 32 32 32 32 35 35 35 35 32 35 35 35 01 01 01 01 01 01 35 32 32 32 35 35 35 35 35 26 26 32 32 32 32 35 26
32 32 35 35 35 35 35 01 01 01 01 35 35 35 35 35 35 07 07 07 07 07 07 07 35 35 35 35 35 35 32 32 32 35 35 35 01 01 01 35 01 01 01 01 01 01 01 4F 32 32 32 35 35 01 35 35 26 26 26 32 32 35 26 26
32 32 32 35 35 35 35 35 01 01 35 35 35 35 35 35 35 07 33 33 33 33 33 07 35 35 35 35 35 35 35 32 32 32 35 35 35 01 01 01 01 01 01 01 01 01 01 01 32 32 35 35 35 35 35 26 26 26 26 26 26 26 26 26
32 32 35 35 35 35 35 35 35 35 35 35 35 35 35 35 35 07 33 33 33 33 4F 07 35 35 35 35 35 35 32 32 32 32 32 35 35 35 35 01 01 01 01 01 35 01 01 01 32 32 32 35 35 35 26 26 26 26 26 26 26 26 26 26
32 32 35 35 35 35 35 35 35 45 35 35 35 35 35 35 35 07 33 33 33 33 4F 07 35 35 35 35 35 32 32 32 32 32 32 32 32 35 35 35 35 35 01 01 35 35 01 01 01 32 32 32 35 35 35 26 26 26 26 26 26 26 26 26
32 32 32 35 35 07 07 07 07 23 07 07 07 35 35 35 35 07 07 07 09 07 07 07 35 35 35 35 35 32 32 32 32 32 32 4F 32 32 35 35 35 35 35 01 01 35 35 35 32 32 32 35 35 35 35 35 35 26 26 26 26 26 26 26
32 32 32 35 35 07 22 2E 2E 2E 2E 2E 07 35 35 35 35 35 35 32 32 32 35 35 35 35 35 35 32 32 35 32 32 32 32 32 32 32 32 32 32 35 35 35 35 35 32 32 32 35 35 35 35 35 35 35 35 35 35 26 26 26 26 26
32 35 35 35 35 23 2E 2E 2D 2E 2E 2B 07 01 35 35 35 35 35 35 32 32 32 35 35 35 35 35 32 32 32 32 32 32 32 01 01 32 4F 32 32 32 32 35 32 32 32 32 35 35 35 35 35 01 35 35 01 35 35 35 26 26 26 26
35 35 35 35 01 07 22 2E 2E 2E 2B 2B 07 01 01 01 35 35 35 35 35 35 32 32 32 35 35 32 32 32 35 35 32 32 32 35 01 01 01 01 32 32 32 32 32 35 35 35 35 35 35 35 01 01 35 35 35 35 26 26 26 26 26 26
32 35 01 01 01 07 2E 2E 2E 2E 2E 2B 07 01 01 01 01 35 32 35 35 35 35 32 32 32 32 32 35 35 35 35 35 32 32 32 35 01 01 01 01 35 35 35 35 35 35 35 35 35 35 35 35 35 35 35 35 26 26 26 26 26 26 26
32 01 01 01 35 07 07 09 07 07 09 07 07 35 01 01 35 32 32 32 35 35 35 32 32 32 35 35 35 35 35 35 35 32 32 32 32 01 01 01 01 01 01 35 35 35 35 35 01 01 35 35 35 35 35 26 26 26 26 26 26 26 26 26
32 32 32 01 01 07 33 4F 33 33 4F 33 07 01 01 01 35 35 32 32 32 32 32 32 32 35 35 35 35 35 35 35 32 32 32 32 32 47 01 01 01 01 01 35 35 35 35 01 01 01 01 35 35 35 35 35 26 26 26 26 26 26 26 26
32 32 01 01 01 07 33 33 33 33 33 33 07 01 01 35 35 35 35 32 32 32 32 32 32 32 35 35 35 35 35 32 32 32 32 32 35 35 35 35 01 01 35 35 35 01 01 01 01 01 01 01 01 35 35 35 35 26 26 26 26 26 26 26
32 01 01 01 01 07 33 33 33 33 33 33 07 01 01 01 35 35 35 35 35 32 32 32 32 35 35 35 35 35 32 32 32 32 35 35 35 35 35 35 35 35 35 01 01 01 01 01 01 01 35 35 35 35 35 35 35 26 26 26 26 26 26 26
32 35 01 01 01 07 33 33 33 33 33 33 07 01 01 01 01 35 35 35 35 35 35 32 32 32 35 35 35 32 32 32 32 35 35 35 35 35 35 35 07 07 07 07 07 07 07 07 07 07 07 07 35 35 35 35 26 26 26 26 26 26 26 26
35 35 35 01 01 07 07 07 08 30 07 07 07 01 01 35 35 35 35 35 35 35 32 32 32 35 35 35 35 35 32 32 32 32 35 35 35 35 35 35 07 29 29 37 29 29 09 33 33 33 33 07 35 35 35 26 26 26 26 26 26 26 26 26
35 35 01 01 01 01 01 33 33 33 33 35 01 01 35 35 35 35 35 35 35 32 32 32 32 35 35 35 35 35 35 32 32 32 35 35 35 35 35 35 07 07 07 09 07 07 07 33 33 33 33 07 35 35 35 35 26 26 26 26 26 26 26 26
35 35 35 35 01 01 01 35 35 33 32 32 32 01 32 32 35 35 35 32 32 32 32 35 35 35 35 32 32 35 35 32 32 32 32 35 35 35 35 35 07 33 33 4F 33 33 07 4F 4F 33 33 07 35 35 35 35 26 26 26 26 26 26 26 26
32 35 35 35 35 35 35 35 35 35 35 35 32 32 32 32 32 35 32 32 32 32 32 32 35 32 32 32 32 32 32 32 32 32 32 32 35 35 35 35 07 33 33 33 33 33 07 07 07 09 07 07 35 35 35 35 35 26 26 26 26 26 26 26
32 32 32 35 35 35 35 35 35 35 35 01 44 01 32 32 32 32 32 32 35 35 32 32 32 32 32 35 35 32 32 32 32 32 32 32 32 32 4F 35 07 33 33 33 33 33 07 01 01 32 35 35 01 01 35 35 35 35 26 26 26 26 26 26
32 35 35 35 35 35 35 35 35 35 01 01 01 01 01 35 35 32 32 35 35 35 35 32 32 32 35 35 01 01 01 32 32 32 35 35 32 32 32 32 07 33 33 33 33 33 07 01 32 32 01 01 01 35 35 35 35 35 26 26 26 26 26 26
32 32 35 35 35 35 35 35 35 35 35 01 01 01 35 35 35 35 35 35 35 35 35 32 32 32 01 01 01 01 01 32 32 32 01 35 01 01 32 32 07 07 07 30 08 07 07 32 32 01 01 01 35 35 35 35 01 26 26 26 26 26 26 26
32 32 35 35 35 35 35 35 35 4F 35 35 35 35 35 35 35 35 35 35 35 35 35 35 32 32 32 01 01 01 01 32 32 32 01 01 01 01 35 32 32 32 32 32 35 35 32 32 35 35 01 35 35 35 35 01 01 01 26 26 26 26 26 26
32 35 35 35 35 35 35 35 35 35 35 35 35 35 35 35 35 32 32 35 35 35 35 32 32 01 01 01 35 35 32 32 32 32 32 35 01 35 35 01 01 01 32 32 32 32 32 32 35 35 35 35 35 35 01 01 01 01 01 26 26 26 26 26
32 32 35 35 35 35 35 35 35 35 35 35 35 35 35 32 32 32 32 32 35 35 32 32 01 01 01 35 35 32 32 26 32 26 32 32 35 01 01 01 01 01 01 01 35 35 32 32 32 32 35 35 35 35 35 01 01 01 4F 01 26 26 26 26
32 32 32 35 35 35 35 35 35 35 35 35 35 35 32 32 32 35 35 32 32 35 35 32 32 01 01 35 32 32 26 26 35 26 26 32 32 35 01 01 01 01 01 01 01 35 35 32 32 32 32 35 32 32 32 01 01 32 32 32 26 26 26 26
32 32 32 32 32 32 35 35 35 35 32 32 32 32 32 32 35 01 01 35 32 32 35 35 32 01 01 32 32 26 26 35 32 35 26 26 32 32 01 01 01 32 35 35 01 01 35 35 32 32 32 32 32 32 01 01 01 32 26 26 26 26 26 26
32 32 32 32 32 32 32 32 32 32 32 32 32 32 32 35 01 01 01 35 32 32 32 32 32 32 32 32 32 32 35 32 34 32 35 32 32 32 32 32 32 32 32 35 35 35 32 32 32 32 32 32 32 32 32 32 32 32 26 26 26 26 26 26
32 32 35 35 35 32 32 32 32 32 32 32 35 32 32 32 32 35 35 32 32 32 4F 4F 32 01 01 32 32 26 26 35 32 35 26 26 32 32 01 01 32 32 32 32 32 32 32 32 32 35 35 32 32 01 01 01 01 32 26 26 26 26 26 26
32 35 35 35 35 35 32 32 35 35 35 35 35 35 35 32 32 32 32 32 35 35 35 35 01 01 01 01 32 32 26 26 35 26 26 32 32 35 01 32 01 01 01 35 32 32 32 35 35 35 35 35 32 35 4F 01 01 32 32 26 26 26 26 26
32 32 35 35 35 32 32 35 35 35 35 35 35 35 35 35 35 35 32 32 32 35 35 01 01 01 01 01 35 32 32 26 32 26 32 32 35 01 01 01 01 35 35 35 32 32 35 35 35 35 35 35 35 35 35 01 01 01 32 32 26 26 26 26
32 35 35 35 35 35 32 32 35 35 35 35 01 01 01 01 01 01 01 35 32 32 35 32 32 01 01 01 01 35 32 32 32 32 32 35 01 01 01 01 35 35 35 35 32 32 32 35 35 35 35 35 35 35 01 01 01 01 01 01 26 26 26 26
35 35 35 35 35 32 32 35 35 35 01 01 35 35 01 01 01 01 01 01 32 32 32 32 01 01 01 35 01 01 01 32 32 32 01 01 01 01 01 35 35 35 35 35 35 32 32 32 35 35 35 01 35 35 35 01 01 01 01 35 35 35 26 26
35 35 35 35 32 32 35 35 35 01 01 35 2F 35 35 35 35 01 01 35 35 35 32 32 32 32 35 01 01 01 01 32 32 32 01 01 35 35 01 01 35 35 35 35 35 35 32 32 35 35 01 01 01 35 35 35 01 01 01 35 01 35 26 26
32 35 35 35 35 32 32 01 01 01 01 33 33 35 35 33 2F 35 01 01 01 35 35 32 32 35 35 35 35 01 01 01 32 32 35 01 01 01 35 35 35 35 35 35 35 32 32 35 35 01 01 01 35 35 35 35 35 35 01 01 35 26 26 26
32 32 01 01 35 32 32 01 01 01 33 33 35 2F 35 33 33 33 35 01 01 35 35 35 35 35 35 35 35 35 01 32 32 01 01 01 35 35 35 35 35 35 35 32 32 32 35 35 35 35 01 01 01 35 35 35 35 35 35 35 26 26 26 26
32 01 01 01 32 4F 01 01 35 35 2F 35 35 35 33 2F 33 33 01 01 01 01 35 35 35 35 35 35 35 35 35 32 32 32 01 35 35 35 35 35 35 35 32 32 32 35 35 35 35 35 01 01 01 01 35 35 35 35 35 26 26 26 26 26
01 01 01 32 32 01 01 01 01 35 35 35 33 2F 33 33 35 33 33 33 32 32 35 35 35 35 35 35 35 35 35 35 32 32 32 35 35 35 35 35 35 32 32 32 35 35 35 35 35 01 01 01 35 35 35 35 35 35 35 26 26 26 26 26
35 01 01 32 32 35 01 01 01 35 35 33 33 33 33 35 2F 35 01 32 32 32 32 32 32 32 35 35 32 35 35 35 35 32 32 32 35 35 35 32 32 32 32 35 35 35 35 35 01 01 01 01 26 26 26 35 35 26 26 26 26 26 26 26
35 35 32 32 35 01 01 01 35 35 2F 35 2F 33 35 35 35 35 01 01 01 01 32 32 32 32 32 32 32 32 32 35 32 32 32 32 32 32 32 32 32 32 32 32 32 35 35 35 35 35 01 26 26 26 26 26 26 26 26 26 26 26 26 26
32 35 32 32 35 35 01 01 01 01 35 35 35 01 01 35 35 01 01 01 35 35 35 35 32 32 32 32 32 32 32 32 32 35 32 32 32 32 32 35 35 35 32 4F 32 32 35 35 35 26 26 26 26 26 35 26 01 01 01 26 26 26 26 26
32 32 32 32 32 35 35 01 01 01 33 01 01 01 01 01 01 01 01 35 35 35 32 32 32 35 35 32 32 32 32 32 35 35 35 32 35 35 35 35 35 35 35 35 32 32 32 35 35 35 26 26 26 35 01 01 01 01 01 01 01 26 26 26
32 32 32 32 35 35 35 35 01 01 01 01 35 35 01 01 35 35 35 35 32 32 32 35 35 35 35 35 32 32 32 35 35 35 32 32 35 35 35 35 35 35 07 07 07 30 08 07 07 01 35 26 26 01 01 01 21 21 21 21 21 01 26 26
32 01 32 32 35 35 35 35 35 35 35 35 35 35 35 35 35 35 32 32 32 35 35 35 35 35 35 35 35 32 32 32 32 32 32 35 35 35 35 35 35 35 07 33 33 33 33 33 07 01 01 26 26 26 01 01 21 33 48 33 21 01 01 26
01 01 01 32 32 35 35 35 35 35 35 35 35 35 35 35 35 35 35 32 32 32 35 35 35 35 35 35 35 4F 32 32 32 32 32 35 35 35 35 35 35 35 07 32 33 33 33 32 07 01 01 01 26 26 01 01 21 33 33 33 21 01 01 26
35 01 01 01 32 32 35 35 35 35 35 35 35 26 26 35 35 35 35 32 32 35 35 35 35 35 35 35 35 35 35 32 32 32 35 35 35 4F 35 35 35 35 07 32 32 43 33 32 07 01 01 35 26 26 26 01 21 21 33 21 21 01 26 26
01 01 32 32 32 35 35 35 35 35 35 26 26 26 26 26 26 35 07 07 09 07 07 35 35 35 35 35 35 35 32 32 32 35 35 35 35 35 35 35 35 35 07 33 32 33 33 33 07 01 01 26 26 26 26 01 01 01 01 01 01 01 01 26
35 35 32 32 35 35 35 35 26 26 26 26 26 26 26 35 35 35 07 33 33 40 07 35 35 35 35 35 35 32 32 32 35 35 35 35 35 35 35 35 35 35 07 07 07 07 07 07 07 01 26 26 26 26 26 26 26 01 01 34 01 01 26 26
35 32 32 35 35 35 35 35 35 35 26 26 35 35 35 35 35 35 07 33 33 33 07 35 35 35 35 35 35 01 32 32 32 35 01 01 35 35 35 35 35 35 35 35 35 01 01 01 01 01 35 26 26 26 26 26 35 35 01 01 01 01 26 26
32 32 32 35 35 35 35 35 35 26 26 26 26 35 35 35 35 35 07 33 33 33 07 35 35 35 35 35 01 01 01 35 32 01 01 01 01 35 35 35 35 35 35 35 01 01 01 01 01 01 4F 26 26 26 26 26 26 35 35 01 01 26 26 26
32 35 32 32 35 35 35 26 26 26 26 35 35 35 35 35 35 35 07 07 07 07 07 35 35 35 35 35 35 01 01 01 32 32 01 01 01 01 01 01 35 35 35 35 35 01 01 01 01 26 26 26 26 35 01 26 26 26 26 26 26 26 26 26
35 35 35 32 35 26 26 26 26 26 35 35 35 35 35 35 35 4F 35 35 35 35 35 35 35 35 35 35 01 01 32 32 32 32 32 32 01 01 01 01 01 35 35 35 35 01 01 01 01 26 26 35 35 01 01 01 26 26 26 26 26 26 26 26
35 35 32 32 35 35 26 35 26 26 26 35 35 26 26 26 26 35 35 35 35 26 26 35 35 35 35 01 01 01 32 26 26 26 26 32 32 32 32 01 01 01 35 35 35 35 01 26 26 26 26 26 01 01 35 26 26 26 26 26 26 26 26 26
32 32 32 35 35 35 35 35 35 26 26 26 26 26 26 26 26 26 35 26 26 26 26 26 35 26 26 35 01 01 32 26 26 26 26 26 26 26 32 32 01 01 01 35 35 26 26 26 26 26 26 26 26 26 26 26 26 26 26 26 26 26 26 26
07 07 09 07 07 35 35 35 26 26 26 26 26 26 26 26 26 26 26 26 26 26 26 26 26 26 26 26 26 01 32 26 26 26 26 26 26 26 26 32 01 01 35 26 26 26 26 26 26 26 26 26 26 26 26 26 26 26 26 26 26 26 26 26
07 33 33 42 07 35 35 26 26 26 26 26 26 26 26 26 26 26 26 26 26 26 26 26 26 26 26 26 26 26 26 26 26 26 26 26 26 26 26 26 26 26 26 26 26 26 26 26 26 26 26 26 26 26 26 26 26 26 26 26 26 26 26 26
07 33 33 33 07 26 26 26 26 26 26 26 26 26 26 26 26 26 26 26 26 26 26 26 26 26 26 26 26 26 26 26 26 26 26 26 26 26 26 26 26 26 26 26 26 26 26 26 26 26 26 26 26 26 26 26 26 26 26 26 26 26 26 26
07 33 33 33 07 26 26 26 26 26 26 26 26 26 26 26 26 26 26 26 26 26 26 26 26 26 26 26 26 26 26 26 26 26 26 26 26 26 26 26 26 26 26 26 26 26 26 26 26 26 26 26 26 26 26 26 26 26 26 26 26 26 26 26
07 07 07 07 07 26 26 26 26 26 26 26 26 26 26 26 26 26 26 26 26 26 26 26 26 26 26 26 26 26 26 26 26 26 26 26 26 26 26 26 26 26 26 26 26 26 26 26 26 26 26 26 26 26 26 26 26 26 26 26 26 26 26 26